            0 0 0 0 0 0 0 0 0 0 0 0 0 0 0 0 0 0 0 0 0
            3 0 0 0 0 0 0 0 0 0 0 0 0 0 0 0 0 0 0 0 3
            3 0 0 0 0 0 0 0 0 0 0 0 0 0 0 0 0 0 0 0 3
            3 0 0 0 0 0 0 0 0 0 0 0 0 0 0 0 0 0 0 0 3
            3 0 0 3 3 0 0 3 3 0 0 3 3 0 0 3 3 3 0 0 3
            3 0 0 3 3 0 0 3 3 0 0 3 3 0 0 3 3 3 0 0 3
            3 0 0 3 3 0 0 3 3 0 0 3 3 0 0 3 3 3 0 0 3
            3 0 0 3 3 0 0 3 3 0 0 3 3 0 0 3 3 3 0 0 3
            3 0 0 3 3 0 0 3 3 0 0 3 3 0 0 3 3 3 0 0 3
            3 0 0 3 3 0 0 3 3 0 0 3 3 0 0 3 3 3 0 0 3
            3 0 0 3 3 0 0 3 3 0 0 3 3 0 0 3 3 3 0 0 0
            3 0 0 3 3 0 0 3 3 0 0 3 3 0 0 3 3 3 0 0 0
            0 0 0 3 3 0 0 3 3 0 0 3 3 0 0 3 3 3 0 0 0
            0 0 0 3 3 0 0 3 3 0 0 3 3 0 0 3 3 3 0 0 0
            2 2 2 3 3 2 2 3 3 2 2 3 3 3 2 3 3 3 2 2 2
            4 4 4 4 4 4 4 4 4 4 4 4 4 4 4 4 4 4 4 4 4
BOOMERANG 64 192 1088 192
MOVING 128 704 128 256
MOVING 384 768 384 256
MOVING 640 704 640 256
MOVING 832 768 832 256
MOVING 1216 576 1216 256

