            0 0 0 0 0 0 0 0 0 0 0 0 3 3 0 0 0 0 3 3 0
            0 0 0 0 0 0 0 0 0 0 0 0 3 3 0 0 0 0 3 3 0
            3 3 3 3 0 0 3 3 0 0 3 3 3 3 0 0 3 3 0 0 0
            3 3 3 3 0 0 3 3 0 0 3 3 3 3 0 0 3 3 0 0 3
            3 0 0 0 0 0 3 3 0 0 0 0 0 0 0 0 0 0 0 0 3
            3 0 0 0 0 0 3 3 0 0 0 0 0 0 0 0 0 0 0 0 3
            3 3 3 3 0 0 3 3 0 0 3 3 3 3 0 0 3 3 3 0 3
            3 3 3 3 0 0 3 3 0 0 3 3 3 3 0 0 3 3 3 0 3
            3 0 0 0 0 0 3 3 0 0 0 0 0 0 0 0 0 0 0 0 3
            3 0 0 0 0 0 3 3 0 0 0 0 0 0 0 0 0 0 0 0 3
            3 3 3 3 0 0 3 3 0 0 0 0 3 3 0 0 0 0 3 0 3
            3 3 3 3 0 0 3 3 0 0 0 0 3 3 0 0 0 0 3 0 3
            0 0 0 0 0 0 3 3 0 0 3 3 0 0 0 0 3 3 0 0 0
            0 0 0 0 0 0 3 3 0 0 3 3 0 0 0 0 3 3 0 0 0
            2 2 2 2 2 2 3 3 2 2 3 3 2 2 2 2 3 3 2 2 2
            4 4 4 4 4 4 4 4 4 4 4 4 4 4 4 4 4 4 4 4 4
BOOMERANG 320 832 320 0
MOVING 0 576 320 576
MOVING 0 320 320 320
BOOMERANG 512 576 1088 576
BOOMERANG 512 576 512 0
MOVING 640 320 1152 320



